. . . . . . . . . . . . . . . . .
. . X . . . . . . # # # . . . . .
. E # # # # # # O # C # # # # . .
. . . . . . . # . # # # . . # . .
. . . . . . O # . . . . . . # . .
. . . . . . O # . . . . . # # # .
. . . . . . . # O . . . . # O # .
. . . . . . . # . O . . . # # # .
. . . . . . . # # . O . . . # . .
. . . . . . . . # # # # # # # . .
. . . . . . . . . . . O O . . . .
. . . . . . . . . . . . . . . . .
