. . . . . # # # . . . . . . . .
. . . . # # . # # . O O O . . .
. . . . # . O . # . . . . . . .
. # # # # . . . # # # # # . . .
. # . . . . . . . . . . # # . O
# # # . . . . . . . . . . # . O
# C # . . . . . . . O . . # . O
# # # . . . . . . . . . . # . O
. # . . . . . . . . . . # # . O
. # # # # . . . . # # # # . . .
. . . . # . . O . # . . . . . .
. . . . . . . . . # . O O . . .
. . . . . . . . . E . . . . . .
