. . . . . . . . . . . . . . . . .
. . . . . . . . . # # # . . . . .
. E # # # # # # . # C # # # # . .
. . . . . . . # . # # # . . # . .
. . . . . . O # . . . . . . # . .
. . . . . . O # . . . . . # # # .
. . . . . . . # O . . . . # O # .
. . . . . . . # . O . . . # # # .
. . . . . . . # # . O . . . # . .
. . . . . . . . # # # # # # # . .
. . . . . . . . . . . O O . . . .
. . . . . . . . . . . . . . . . .
